ACCESORY	AE K S AH Z AO R IY
AFTERNOON	AE F T ER N UW N
ALCOHOL	AE L K AH HH AA L
AM	AE M
AM(2)	EY EH M
AND	AH N D
AND(2)	AE N D
APPLE	AE P AH L
APPLIANCE	AH P L AY AH N S
APRIL	EY P R AH L
AQUA	AE K W AH
AQUA(2)	AA K W AH
ARE	AA R
ARE(2)	ER
ARM	AA R M
AUGUST	AA G AH S T
AUGUST(2)	AO G AH S T
BAG	B AE G
BAHT	B AA T
BAKERY	B EY K ER IY
BANANA	B AH N AE N AH
BAR	B AA R
BED	B EH D
BEDROOM	B EH D R UW M
BEER	B IH R
BEIGE	B EY ZH
BENCH	B EH N CH
BILLION	B IH L Y AH N
BIN	B IH N
BLACK	B L AE K
BLUE	B L UW
BOARD	B AO R D
BOOK	B UH K
BOOKSHELF	B UH K SH EH L F
BREAD	B R EH D
BROWN	B R AW N
BRUSH	B R AH SH
BUTTER	B AH T ER
BYE	B AY
CABINET	K AE B AH N AH T
CABINET(2)	K AE B N AH T
CAKE	K EY K
CALORIES	K AE L AO R IY Z
CAMERA	K AE M ER AH
CAMERA(2)	K AE M R AH
CANCEL	K AE N S AH L
CANDY	K AE N D IY
CARAMEL	K EH R AH M AH L
CARE	K EH R
CATEGORY	K AE T AH G AO R IY
CENTIMETER	S EH N T AH M IY T ER
CHAIR	CH EH R
CHEESE	CH IY Z
CHOCOLATE	CH AO K L AH T
CLEAR	K L IH R
COFFEE	K AA F IY
COFFEE(2)	K AO F IY
COKE	K OW K
COLA	K OW L AH
COLLON	K AA L AA N
COLOR	K AH L ER
COLOR(2)	K AO L ER
COMPUTER	K AH M P Y UW T ER
CONE	K OW N
COOKIES	K UH K IY Z
CORN	K AO R N
COSMETICS	K AA Z M EH T IH K S
COSTUME	K AA S T UW M
COUNTER	K AW N T ER
CRACKERS	K R AE K ER Z
CREAM	K R IY M
CUBE	K Y UW B
CUBIC	K Y UW B IH K
CUBOID	K Y UW B OY D
CUPBOARD	K AH B ER D
CYLINDER	S IH L AH N D ER
CYLINDER(2)	S IH L IH N D ER
DARK	D AA R K
DATE	D EY T
DAY	D EY
DECEMBER	D IH S EH M B ER
DESK	D EH S K
DEVICE	D IH V AY S
DINING	D AY N IH NG
DO	D UW
DOLL	D AA L
DONUT	D OW N AH T
DRESSER	D R EH S ER
DRINK	D R IH NG K
DROPS	D R AA P S
DRUG	D R AH G
DUST	D AH S T
EGG	EH G
EIGHT	EY T
EIGHTEEN	EY T IY N
EIGHTY	EY T IY
ELECTRONIC	IH L EH K T R AA N IH K
ELEVEN	IH L EH V AH N
ELEVEN(2)	IY L EH V AH N
ENERGY	EH N ER JH IY
EQUIPMENT	IH K W IH P M AH N T
ERASER	IH R EY S ER
ERASER(2)	IY R EY S ER
EVENING	IY V N IH NG
EXPIRATION	EH K S P ER EY SH AH N
FANTA	F AA N T AH
FEATURE	F IY CH ER
FEBRUARY	F EH B Y AH W EH R IY
FEBRUARY(2)	F EH B R UW EH R IY
FIFTEEN	F IH F T IY N
FIFTY	F IH F T IY
FINE	F AY N
FIVE	F AY V
FOAM	F OW M
FOOD	F UW D
FORTY	F AO R T IY
FOUR	F AO R
FOURTEEN	F AO R T IY N
FRIDGE	F R IH JH
FRUIT	F R UW T
GARLIC	G AA R L IH K
GOLD	G OW L D
GOOD	G UH D
GOOD(2)	G IH D
GRAPEFRUIT	G R EY P F R UW T
GRAY	G R EY
GREEN	G R IY N
GUY	G AY
HALLWAY	HH AO L W EY
HAM	HH AE M
HAMBURGER	HH AE M B ER G ER
HANAMI	HH AE N AH M IY
HANGER	HH AE NG ER
HAVE	HH AE V
HEALTH	HH EH L TH
HEIGHT	HH AY T
HELLO	HH AH L OW
HELLO(2)	HH EH L OW
HEY	HH EY
HI	HH AY
HOTDOG	HH AA T D AO G
HOW	HH AW
HUNDRED	HH AH N D R AH D
HUNDRED(2)	HH AH N D R IH D
HUNDRED(3)	HH AH N ER D
HUNDRED(4)	HH AH N D ER D
I	AY
I-PAD	AY P AE D
I-PHONE	AY F OW N
IS	IH Z
IT	IH T
JACKET	JH AE K AH T
JACKET(2)	JH AE K IH T
JANUARY	JH AE N Y UW EH R IY
JUICE	JH UW S
JULY	JH UW L AY
JULY(2)	JH AH L AY
JUNE	JH UW N
KEYBOARD	K IY B AO R D
KINECT	K IH N AH K T
KITCHEN	K IH CH AH N
LAYS	L EY Z
LEMON	L EH M AH N
LIBRARY	L AY B R EH R IY
LIGHT	L AY T
LIQUID	L IH K W AH D
LIQUID(2)	L IH K W IH D
LIVING	L IH V IH NG
LOCATION	L OW K EY SH AH N
LONG	L AO NG
LOTION	L OW SH AH N
MAC	M AE K
MACHINE	M AH SH IY N
MARCH	M AA R CH
MARMELADE	M AA R M AH L EY D
MAY	M EY
MEDICINE	M EH D AH S AH N
MICROPHONE	M AY K R AH F OW N
MILK	M IH L K
MILLION	M IH L Y AH N
MONTH	M AH N TH
MORNING	M AO R N IH NG
NAME	N EY M
NIGHT	N AY T
NINE	N AY N
NINETEEN	N AY N T IY N
NINETY	N AY N T IY
NO	N OW
NOT	N AA T
NOTEBOOK	N OW T B UH K
NOVEMBER	N OW V EH M B ER
OBJECT	AA B JH EH K T
OBJECT(2)	AH B JH EH K T
OCTOBER	AA K T OW B ER
OISHI	OW IY SH IY
ONE	W AH N
ONE(2)	HH W AH N
ORANGE	AO R AH N JH
ORANGE(2)	AO R IH N JH
OREO	AO R IY OW
PANTRY	P AE N T R IY
PAPER	P EY P ER
PARTY	P AA R T IY
PC	P IY S IY
PEANUT	P IY N AH T
PEN	P EH N
PENCIL	P EH N S AH L
PERSONAL	P ER S IH N AH L
PILLOW	P IH L OW
PINK	P IH NG K
PIZZA	P IY T S AH
PLANT	P L AE N T
POPCORN	P AA P K AO R N
POTATO	P AH T EY T OW
POWDER	P AW D ER
PRICE	P R AY S
PRISM	P R IH Z AH M
PRODUCTION	P R AH D AH K SH AH N
PRODUCTION(2)	P R OW D AH K SH AH N
PRODUCTION(3)	P ER D AH K SH AH N
PUFF	P AH F
PURPLE	P ER P AH L
PYRAMID	P IH R AH M IH D
RECEPTION	R IH S EH P SH AH N
RECEPTION(2)	R IY S EH P SH AH N
RED	R EH D
ROBOT	R OW B AA T
ROBOT(2)	R OW B AH T
ROOM	R UW M
SAMSUNG	S AE M S AH NG
SANDWITCH	S AE N D W IH CH
SAUCE	S AO S
SAUSAGE	S AO S AH JH
SAUSAGE(2)	S AO S IH JH
SEPTEMBER	S EH P T EH M B ER
SEVEN	S EH V AH N
SEVENTEEN	S EH V AH N T IY N
SEVENTY	S EH V AH N T IY
SHAMPOO	SH AE M P UW
SHAPE	SH EY P
SHELF	SH EH L F
SHIRT	SH ER T
SHOEBOX	SH UW B AA K S
SHORTS	SH AO R T S
SHOWCASE	SH OW K EY S
SIDEBOARD	S AY D B OW R D
SIDETABLE	S AY D T EY B AH L
SILVER	S IH L V ER
SINK	S IH NG K
SIR	S ER
SIX	S IH K S
SIXTEEN	S IH K S T IY N
SIXTY	S IH K S T IY
SKIRT	S K ER T
SNACK	S N AE K
SOAF	S OW F
SODA	S OW D AH
SOFA	S OW F AH
SOY	S OY
SPEAKER	S P IY K ER
SPHERE	S F IH R
STAND	S T AE N D
STATIONERY	S T EY SH AH N EH R IY
STOVE	S T OW V
STRAWBERRY	S T R AO B EH R IY
SUIT	S UW T
SWEATER	S W EH T ER
SYRUB	S IH R AH B
T-SHIRT	T IY S ER T
TABLE	T EY B AH L
TABLET	T AE B L AH T
TASTO	T AE S T OW
TEA	T IY
TELEVISION	T EH L AH V IH ZH AH N
TEN	T EH N
THANK	TH AE NG K
THIRTEEN	TH ER T IY N
THIRTY	TH ER D IY
THIS	DH IH S
THOUSAND	TH AW Z AH N D
THOUSAND(2)	TH AW Z AH N
THREE	TH R IY
TISSUE	T IH S Y UW
TISSUE(2)	T IH SH UW
TOFFEE	T AA F IY
TOMATO	T AH M EY T OW
TOMATO(2)	T AH M AA T OW
TOOTH	T UW TH
TV	T IY V IY
TV(2)	T EH L AH V IH ZH AH N
TWELVE	T W EH L V
TWENTY	T W EH N T IY
TWO	T UW
UMBRELLA	AH M B R EH L AH
UP	AH P
VALUE	V AE L Y UW
VANILLA	V AH N IH L AH
VEGETABLE	V EH JH T AH B AH L
VIOLET	V AY AH L IH T
VOLUMN	V AA L AH M
WANT	W AA N T
WANT(2)	W AO N T
WATER	W AO T ER
WEBCAM	W EH B K AE M
WHAT	W AH T
WHAT(2)	HH W AH T
WHITE	W AY T
WHITE(2)	HH W AY T
WIDTH	W IH D TH
WINE	W AY N
YAKULT	Y AE K AH L T
YEAR	Y IH R
YELLOW	Y EH L OW
YES	Y EH S
YOGURT	Y OW G ER T
YOU	Y UW
