A	AH
A(2)	EY
BRING	B R IH NG
CARRY	K AE R IY
CARRY(2)	K EH R IY
DELIVER	D IH L IH V ER
FIND	F AY N D
FOR	F AO R
FOR(2)	F ER
FOR(3)	F R ER
GET	G EH T
GET(2)	G IH T
GIVE	G IH V
GRASP	G R AE S P
LOOK	L UH K
ME	M IY
PILL	P IH L
ROBOT	R OW B AA T
ROBOT(2)	R OW B AH T
TAKE	T EY K
TO	T UW
TO(2)	T IH
TO(3)	T AH
