A	AH
A(2)	EY
AN	AE N
AN(2)	AH N
CRACK	K R AE K
EGG	EH G
GET	G EH T
GET(2)	G IH T
HALT	HH AO L T
HALTING	HH AO L T IH NG
INTRODUCE	IH N T R AH D UW S
INTRODUCE(2)	IH N T R OW D UW S
NO	N OW
OUT	AW T
PLEASE	P L IY Z
ROBOT	R OW B AA T
ROBOT(2)	R OW B AH T
STOP	S T AA P
THE	DH AH
THE(2)	DH IY
YES	Y EH S
YOURSELF	Y ER S EH L F
YOURSELF(2)	Y UH R S EH L F
YOURSELF(3)	Y AO R S EH L F
