ALRIGHT	AO L R AY T
AM	AE M
AM(2)	EY EH M
ANYTHING	EH N IY TH IH NG
BREAKFAST	B R EH K F AH S T
CANCEL	K AE N S AH L
CORNFLAKE	K AO R N F L EY K
FOLLOW	F AA L OW
GET	G EH T
GET(2)	G IH T
HUNGRY	HH AH NG G R IY
I	AY
ME	M IY
NEED	N IY D
NO	N OW
NOTHING	N AH TH IH NG
OUT	AW T
ROBOT	R OW B AA T
ROBOT(2)	R OW B AH T
STOP	S T AA P
WANT	W AA N T
WANT(2)	W AO N T
WHATEVER	W AH T EH V ER
WHATEVER(2)	HH W AH T EH V ER
YES	Y EH S
