CHECK	CH EH K
CLEAN	K L IY N
COME	K AH M
FOLLOW	F AA L OW
GOOD	G UH D
GOOD(2)	G IH D
HALT	HH AO L T
HERE	HH IY R
IN	IH N
JOB	JH AA B
JOB(2)	JH OW B
ME	M IY
NO	N OW
OUT	AW T
STOP	S T AA P
THANK	TH AE NG K
UP	AH P
WAIT	W EY T
WAITING	W EY T IH NG
WITH	W IH DH
WITH(2)	W IH TH
YES	Y EH S
YOU	Y UW
